..oo..o...........oo.....o.........o
..oo..o...........oo................
...o..o..ooo..oo...o..oo....ooo..o..
......o....o..oo......oo......o..o..
......o....o..........oo......o....o
..o...o..ooo......o...oo....ooo.....
..oo..o.......oo..oo.............o..
..oo..o.......oo..oo.....o.......o..
