..oo..o.....o......o..oo..o.....oo.....o....o
..oo..o.....o......o..oo..o......o.....o.....
...o..o..oooo..oo..o...o..o..oo..o..oooo..o..
......o....oo..oo..o......o..oo..o....oo..o..
......o....oo......o......o..oo..o....oo....o
..o...o..oooo......o..o...o..oo..o..oooo.....
..oo..o.....o..oo..o..oo..o......o.....o..o..
..oo..o.....o..oo..o..oo..o.....oo.....o..o..
