ooood.....oo
ooo.d.....oo
o...d...1..o
ol..d.dlllll
.u..h.d..xxx
.u.fx.d.....
.u.xx.d.....
.u....d.....
.u....d...h.
2u....d..3.o
r1..h.d...oo
.s.s.sds.soo
