oooooooooooooo
o............o
o............o
o............o
o............o
o............o
o............o
o.....x......o
o.....x......o
o.....f......o
o.....s......o
o.....s......o
o............o
oooooooooooooo

