oooooooooooooo
o............o
o............o
o............o
o............o
o............o
o............o
o............o
o............o
o.....f......o
o...hx1s.....o
o...uus2.....o
o............o
oooooooooooooo

