oooo......oo
ooo.......oo
o.......1..o
ol..........
.u..x.h..xxx
.u.fx.dlllll
.u.xx.d.....
.u....d.....
.u....d...h.
2u....d..3.o
ru..h.d...oo
.s.s.sds.soo