oooooooooooooo
o............o
o............o
o............o
o............o
o............o
o............o
o............o
o.....f......o
o.....2......o
o...hx1......o
o...uusu.....o
o............o
oooooooooooooo

