ooo.........3..
oo.........xxx.
o.rrrrrhlllll..
..ux.......xu..
..u...x.x...u..
..u.h.....h.u..
..uhx....1xhu.o
o.h...x.....h.o
o.h...f.....h..
..dhx.....xhd..
..d.h...x.h.d..
..d.........d..
..dx.......xd..
..rrrrrhlllll..
o.xxx..........
o..2..s.s.....o