oooooooooooo
oo..d.....xo
o...d....1..
ol..d.dlllll
.u..h.d..xxx
.u.fx.d.....
.u.xx.d.....
.u....d...x.
2u....d..3.o
ru..x.d...oo
.s.s.sds.soo