oo..d.....xx
o...d....1..
ol..d.dlllll
.u..h.d..xxx
.u.fx.d.....
.u.xx.d.....
2u....d..3.o
ru..h.d...oo
.s.s.sds.soo
